1111111111111111111111111111
1E0000000000000C111111111111
1010010100100001111111111111
1010010010101011111111111111
1P0000000C00C000110000000111
1111111111111111111111111111