111111
100001
101001
100001
10P001
111111
