111111111111
111111111111
1E000C000111
1110000101P1
111111111111