111111111
1E0000011
1100000P1
111111111