111111111111
111111111111
1E1000CP0011
1110000000C1
111111111111