11111111
1EC0C011
10000001
1P000011
11111111