111111111111
111111111111
1E100C000111
111000010011
111111111111