111111111111
1E0000011111
110C00001111
110C00001111
110C000P1111
111111111111