111111111111111111
1E0000000000000C11
101001010010000111
101001001010101111
1P0000000C00C00011
111111111111111111