111111111111
111111111111
1E100CP00111
1110000000C1
111111111111