111111111111
111111111111
1E000C000111
1110000100P1
111111111111