11111111
1ECP0011
10000011
10000011
11111111