11111111
1EC00011
11111111
100P0011
11111111