1111111111111111
1ECC1P1111111111
1111111111111111